200,100,5,50,50,0,0,0,0
400,200,5,50,50,0,0,0,0
600,300,10,100,100,0,0,0,0
50,300,10,50,50,0,0,90,1
100,100,10,50,50,1,0,1,1

